width=19&height=22
###################
#·················#
##·######+######·##
#·················#
#·#######@#######·#
#·#·············#·#
#·#·#####·#####·#·#
#·#·#   #·#   #·#·#
#·#·### #·# ###·#·#
#·····###+###·····#
#·###·········###·#
#···###·#·#·###···#
###···#·#·#·#···###
····#·········#····
###·#·#·#·#·#·#·###
##··+·#·#·#·#·+··##
#··##·#·#·#·#·##··#
#·###···#·#···###·#
#·#####·····#####·#
#···#####D#####···#
###···##ABC##···###
###################